###########################################################
#####    ##               ##                    ###   #####
#     ############# ### #### ####### ########## ### ### ###
# ######            #   ##   #    #      ###### #       ###
#     ## ########## # ######## ######### #    # # # ###   B
# ### ##    ##      #       ##    #    # # # ## # # #######
#  ## ## ## ## #### ####### ##### #    # # #### ### #   ###
##       ## ####### #     # ##    ## ### #            #  ##
########### #   ### # ##### ## ##      # ### ####### ### ##
#        ## #   # # #       ## ####### # ##  ##        #  #
# ###### ## ## ## # ########## ####### # ######## ## ######
#   #  # ## ##    # ####     # ##      #        #### ###  #
### ## #    ##  ### #### ### # ## ########## ##    #     ##
###    #### ###          ###   ##            #  ########  #
###A#######################################################
